6 6
1 2 5 4 6 1
2 8 8 7 9 1
7 1 2 6 7 4
9 4 6 4 7 2
5 7 6 7 8 3
5 5 6 6 8 3
